+-+-+-+-+-+-+-+-+-+-+-+-+-+-+-+-+-+-+-+-+
|           |   |       |   |       |    
+-+-+-+-+-+ +-+ + +-+-+ +-+ + +-+-+ + + +
|       | |   | | |   | |     |   | | | |
+ +-+-+ + +-+ + + + + + + +-+-+ + + + +-+
| |     |       | | |   |       | |     |
+-+ + +-+ +-+-+-+ + +-+-+-+-+-+-+-+-+-+ +
|   |   | |       |       |             |
+ +-+ +-+ +-+-+-+-+-+-+ + + +-+-+ +-+-+ +
| |                     | |   | |   |   |
+ +-+-+-+ +-+-+-+-+-+-+-+-+-+ + +-+ + +-+
| |     | |   |   |     |       |   |   |
+ + +-+ + + + +-+ + +-+ + + + + + +-+-+-+
| |   |   | |     |   |   | | | |       |
+ +-+ +-+-+ +-+-+ +-+-+-+-+-+ + + +-+-+ +
|   | |   |     |           | | |   |   |
+ +-+ + + +-+-+ +-+ +-+-+-+ + + +-+ +-+-+
| |   | |       |   |     |   |   |   | |
+ + +-+ +-+-+-+ + +-+-+ +-+-+-+-+ +-+ + +
| | |   |     | |       |     |   |   | |
+ + + +-+ +-+ +-+-+-+ +-+ +-+ + +-+-+-+ +
| | | |     |       | |     | | |   |   |
+-+ + + +-+-+-+-+ + +-+ +-+-+ + + + + + +
|   |   |   |     | |   |     | | |   | |
+ +-+-+-+ + + +-+ +-+ +-+ +-+ + +-+-+ + +
| |       | |   | |   |   |   |     | | |
+ +-+ +-+-+ +-+ +-+ +-+-+-+ +-+-+ + + + +
|     |   | |     | |     | |     |   | |
+-+-+ + + + + + + + + +-+ + + +-+-+-+-+ +
|   |   | |   | | | | |   |   |       | |
+ + +-+-+ +-+-+-+ +-+ +-+-+-+-+ +-+-+ + +
| |   |   |     |   |     |     |       |
+-+-+ + +-+ +-+ +-+ +-+-+ + +-+-+ +-+-+ +
|   | | |     |   |     | |   |   |   | |
+ + + + + +-+-+-+ +-+ + + + + +-+-+ + + +
| |   |     |   | |   |   | |   |   | | |
+-+-+ +-+ + + + + +-+-+-+-+-+-+ + +-+ + +
|   |     | | | |     | |       | |   | |
+ + + +-+-+ + + +-+-+ + + +-+-+-+ +-+-+ +
  |   |     | |       |         |       |
+-+-+-+-+-+-+-+-+-+-+-+-+-+-+-+-+-+-+-+-+
