+-+-+-+-+-+-+-+-+-+-+
    |       |     | |
+-+ + +-+-+ +-+-+ + +
|   | | |     |   | |
+ +-+ + + + + + +-+ +
|     |   | |   |   |
+-+-+-+-+-+ +-+-+ +-+
|           |     | |
+ +-+-+-+-+-+ + +-+ +
|   |   |   | |   | |
+-+ + + + + + +-+ + +
| | | | | | |   | | |
+ + + + + + +-+-+ + +
| | | |   | |   |   |
+ + + +-+ + + + +-+ +
| |   |   |   | |   |
+ + +-+-+-+-+-+ + +-+
| | |           |   |
+ + + +-+-+-+-+-+ + +
|   |             |  
+-+-+-+-+-+-+-+-+-+-+
